Subplot,Active,Inactive,Maybe,Total,Notes
1,15,4,4,23,
2,0,1,1,2,
3,8,0,4,12,
4,2,2,1,5,
5,10,3,5,18,
6,12,2,4,18,
7,30,2,5,37,
8,9,3,5,17,
9,6,5,6,17,2 deaths
10,0,0,1,1,1 death
11,12,1,2,15,
12,20,5,5,30,
13,0,1,0,1,
14,1,1,1,3,
15,0,0,0,0,
16,6,0,3,9,
17,11,2,6,19,
18,6,2,4,12,1 death
19,6,4,5,15,1 death
20,1,2,0,3,
21,3,2,0,5,
22,6,2,0,8,
23,9,2,4,15,
24,15,4,8,27,2 deaths
25,1,1,1,3,
